NO ./textures/wall_north.xpm
SO ./textures/wall_south.xpm
WE ./textures/wall_west.xpm
EA ./textures/wall_east.xpm
C 35,19,73
F 22,45,50

111111111111111
111111111111111
111110000011111
1111000N0001111
111000000000111
110000000000011
100001111100001
110000111000011
111000010000111
111100010001111
111110000011111
111111111111111
111111111111111
