NO ./textures/wall_north.xpm
SO ./textures/wall_south.xpm
WE ./textures/wall_west.xpm
EA ./textures/wall_east.xpm
F 30,30,30
C 200,200,255

11111111111111111111111111111111111111111111111111
1N000000000000000000000000000000000000000000000001
11111111111111111111D11111111111111111111110000001
10000000000000000000000000000000000000000110000001
101111111111111111111111111111D1111111000110000001
10100000000000000000000000000000000111000110000001
10101111111111111111111111111111000111000110000001
10101000000000000000000000000001000111000110000001
10101011111111111111111111111001000111000110000001
10101010000000000000000000001001000111000110000001
10101010111111111111111111001001000111000110000001
10101010100000000000000001001001000111000110000001
101010101011111111D1111001001001000111000110000001
10101010101000000000001001001001000111000110000001
10101010101011111111001001001001000111000110000001
10101010101010000001001001001001000111000110000001
10101010101010111001001001001001000111000110000001
10101010101010101001001001001001000111000110000001
10101010101010101001001001001001000111000110000001
10101010101010101001001001001001000111000110000001
10101010101010101001001001001001000111000110000001
10101010101010101001001001001001000111000110000001
10101010101010101001001001001001000111000110000001
10101010101010101001001001001001000111000110000001
10101010101010101001001001001001000111000110000001
10101010101010101001001001001001000111000110000001
10101010101010101001001001001001000111000110000001
10101010101010101001001001001001000111000110000001
10101010101010101001001001001001000111000110000001
10101010101010101001001001001001000111000110000001
10101010101010101001001001001001000111000110000001
10101010101010101001001001001001000111000110000001
10101010101010101001001001001001000111000110000001
10101010101010101001001001001001000111000110000001
10101010101010101001001001001001000111000110000001
10101010101010101001001001001001000111000110000001
10101010101010101001001001001001000111000110000001
10101010101010101001001001001001000111000110000001
10101010101010101001001001001001000111000110000001
10101010101010101001001001001001000111000110000001
10101010101010101001001001001001000111000110000001
10101010101010101001001001001001000111000110000001
10101010101010101001001001001001000111000110000001
10101010101010101001001001001001000111000110000001
10101010101010101001001001001001000111000110000001
10101010101010101001001001001001000111000110000001
10101010101010101001001001001001000111000110000001
10101010101010101001001001001001000111000110000001
10000000000000000000000000000000000000000000000001
11111111111111111111111111111111111111111111111111
