NO ./textures/wall_north.xpm
SO ./textures/wall_south.xpm
WE ./textures/wall_west.xpm
EA ./textures/wall_east.xpm
F 100,100,100
C 200,200,255

111111111111111111
100001010000010001
101111010111010111
101001010100010100
101011101011101011
101000010001000001
101111111111011111
1000000000000000E1
111111111111111111
